C 64,63,65
F 3,31,32

EA src/map/redbrick.xpm
SO src/map/colorstone.xpm
NO src/map/eagle.xpm
WE src/map/wood.xpm

1111111111111111111
1000010000000001001
1000000000000001001
10000111110N0000001
100001   1000001001
1011111111111001111
1000100000000000001
1000100000000000001
1000100000000000001
1111111111111111111