EA src/map/red_brick.xpm
SO src/map/green_brick.xpm
NO src/map/yellow_brick.xpm
WE src/map/blue2_brick.xpm

C 12,2,40
F 0,188,255

1111111111111111111111111111111111111111111111111111111111111111
1111111111111111111111111110000000000011111111111111111111111111
1111111111111111111111111000000000000001111111111111111111111111
1111111111111111111111111000000000000000111111111111111111111111
1111111111111111111111111000000000000000111111111111111111111111
1111111111111111111111111000000000000000111111111111111111111111
1111111111111111111111110000000000111000011111111111111111111111
1111111111111111111111110000011111111100011111111111111111111111
1111111111111111111111110011111111111110011111111111111111111111
1111111111111111111111100011111111111110011111111111111111111111
1111111111111111111111100010011111111110011111111111111111111111
1111111111111111111111100010001111111110011111111111111111111111
1111111111111111111111100000000111111110011111111111111111111111
1111111111111111111111100000000011000010111111111111111111111111
1111111111111111111111100000000001100110111111111111111111111111
1111111111111111111111110000000001101111111111111111111111111111
1111111111111111111111110000000001111111111111111111111111111111
1111111111111111111111110000000001111111111111111111111111111111
1111111111111111111111100000000001111111111111111111111111111111
1111111111111111111111100000000000111111111111111111111111111111
1111111111111111111111110000000000111111111111111111111111111111
1111111111111111111111110000000011111111111111111111111111111111
1111111111111111111111111100000000011111111111111111111111111111
1111111111111111111111111110000000001111111111111111111111111111
1111111111111111111111111110000000011111111111111111111111111111
1111111111111111111111111110000011111111111111111111111111111111
1111111111111111111111111110000000111111111111111111111111111111
1111111111111111111111111110000001110011111111111111111111111111
1111111111111111111111111110000001000011111111111111111111111111
1111111111111111111111110010000000000011111111111111111111111111
1111111111111111111111100000000000000011111111111111111111111111
1111111111111111111111000000000000000010111111111111111111111111
1111111111111111111100000010000000000010000111111111111111111111
1111111111111111110000000010000000000010000001111111111111111111
111111111111111110000000001100000N000010000000011111111111111111
1111111111111110000000000001100000000011000000000111111111111111
1111111111111000000000000001110110011111000000000001111111111111
1111111111110000000000000000111111000111000000000000111111111111
1111111111000000000000000000111111101111000000000000011111111111
1111111100000000000000000000111111111111000000000000011111111111
1111111100000000000000000000111111011111000000000000011111111111
1111111000000000000000000000111111111111000000000000011111111111
1111111000000000000000000000111001111111000000000000001111111111
1111111000000000000000000000011100111110000000000000001111111111
1111111000000000000010000000000111111100000000000000001111111111
1111111000000000000100000000011110011100000000000000001111111111
1111111000000000000000010000000111111100000000000000001111111111
1111111000000000000000111000000000000000000000000000001111111111
1111111000000000000001111110001111110000000000000000001111111111
1111111000000000000000010000000000000000000000000000001111111111
1111111000000000000000010000001111110000000000000000001111111111
1111111000000000000000011100000000010000000000000000001111111111
1111111100000000000000001100001111000000000000000000001111111111
1111111100000000000000011000000001110000000000000000001111111111
1111111000000000000000011000000100000000000000000000001111111111
1111111000000000000000000000000111110000000000000000001111111111
1111111000000000000000000000000000000000000000000000001111111111
1111110000000000000000100000000111100000000000000000001111111111
1111110000000000000000100000000000000000000000000000001111111111
1111110000000000000000000000000111000000000000000000001111111111
1111100000000000000000000000000000000000000000000000001111111111
1111100000000000000000000000000110000000000000000000001111111111
1111000000000000000000000000000000000000000000000000001111111111
1111111111111111111111111111111111111111111111111111111111111111
