C 64,63,65
F 33,31,32

EA src/map/red_brick.xpm
SO src/map/green_brick.xpm
NO src/map/yellow_brick.xpm
DO src/map/brown-brick.xpm
WE src/map/blue2_brick.xpm

1111
100111
1W0O01
111111
