NO src/map/blue_brick.xpm
SO src/map/cobblestone.xpm
WE src/map/flag.xpm
EA src/map/brown-brick.xpm

F 64,64,64
C 128,128,128

	11111111111111111
	1000000000000001
	111110000000000111
		1000000000000001
	11111000000000011111
	1000000000000001
11111000000000011111
1000000000000001
100000E000000001
11000000000000011
 1000000000000001
 1000111111110001
110001      10001
100001      10001
100001      10001
100001      10001
111101      10111
   101111111101
   100000000001
   111111111111
